================================
=e                            e=
= === === === === === === ===  =
= =   =           =     =   =  =
= =   =                     =  =
= =          p          =====  =
=                              =
================================
