################
#e            e#
# ### ### ###  #
# #         #  #
# # ### ### ## #
# # #   # # #  #
#   # p #   # ##
# # #   # # #  #
# #.###.###.## #
# #         #  #
# ### ### ###  #
#             e#
################