################
#e     +      e#
# ### ### ###  #
# #         #  #
#-# ### ### ## #
# # #+  # # # -#
#   # p #h  # ##
# # #-  # # #  #
# #.###.###.## #
#h#         #  #
# ### ### ###  #
#          +  e#
################